3 3 3 3 3 3 3 3 17 3 3 3 3 3 3 3 3
3 17 17 17 17 17 17 17 17 17 17 17 17 17 17 17 3
3 17 17 17 17 17 17 17 17 17 17 17 17 17 17 17 3
3 17 17 17 17 17 17 17 17 17 17 17 17 17 17 17 3
3 17 17 17 17 17 17 17 17 17 17 17 17 17 17 17 3
3 17 17 17 17 17 17 17 17 17 17 17 17 17 17 17 3
3 17 17 17 17 17 17 17 17 17 17 17 17 17 17 17 17
3 17 17 17 17 17 17 17 17 17 17 17 17 17 17 17 3
3 17 17 17 17 17 17 17 17 17 17 17 17 17 17 17 3
3 17 17 17 17 17 17 17 17 17 17 17 17 17 17 17 3
3 17 17 17 17 17 17 17 17 17 17 17 17 17 17 17 3
3 17 17 17 17 17 17 17 17 17 17 17 17 17 17 17 3
3 3 3 3 3 3 3 3 17 3 3 3 3 3 3 3 3