52 43 44 45 46 43 44 45 46 43 44 45 46 43 44 45 52
51 55 55 55 55 55 55 55 55 55 55 55 55 55 55 55 47
52 55 55 55 55 55 55 55 55 55 55 55 55 55 55 55 48
53 55 55 55 55 55 55 55 55 55 55 55 55 55 55 55 49
54 55 55 55 55 55 55 55 55 55 55 55 55 55 55 55 50
51 55 55 55 55 55 55 55 55 55 55 55 55 55 55 55 47
52 55 55 55 55 55 55 55 55 55 55 55 55 55 55 55 55
53 55 55 55 55 55 55 55 55 55 55 55 55 55 55 55 49
54 55 55 55 55 55 55 55 55 55 55 55 55 55 55 55 50
51 55 55 55 55 55 55 55 55 55 55 55 55 55 55 55 47
52 55 55 55 55 55 55 55 55 55 55 55 55 55 55 55 48
53 55 55 55 55 55 55 55 55 55 55 55 55 55 55 55 49
52 39 40 41 42 39 40 41 42 39 40 41 42 39 40 41 52