56 56 56 56 56 56 56 56 56 56 56 56 56 56 56 56 56
56 58 59 59 59 59 59 59 59 59 59 59 59 59 59 60 56
56 61 66 66 66 66 66 66 66 66 66 66 66 66 66 62 56
56 61 66 66 66 66 66 66 66 66 66 66 66 66 66 62 56
56 61 66 66 66 66 66 66 66 66 66 66 66 66 66 62 56
56 61 66 66 66 66 66 66 66 66 66 66 66 66 66 62 56
57 61 66 66 66 66 66 66 66 66 66 66 66 66 66 62 57
56 61 66 66 66 66 66 66 66 66 66 66 66 66 66 62 56
56 61 66 66 66 66 66 66 66 66 66 66 66 66 66 62 56
56 61 66 66 66 66 66 66 66 66 66 66 66 66 66 62 56
56 61 66 66 66 66 66 66 66 66 66 66 66 66 66 62 56
56 63 64 64 64 64 64 64 64 64 64 64 64 64 64 65 56
56 56 56 56 56 56 56 56 56 56 56 56 56 56 56 56 56